100 100 8 8
$ $ $ $ $ $ $ $ 
$ S $ B B B E $
$ B $ $ $ B $ $
$ B $ B B B $ $
$ B $ $ $ B $ $
$ B B B $ B $ $
$ B $ B B B $ $
$ $ $ $ $ $ $ $ 